atte|aimasu
asonde|asobimasu
atte|arimasu
itte|ikimasu
isoide|isogimasu
okutte|okurimasu
oyoide|oyogimasu
owatte|owarimasu
katte|kaimasu
kaette|kaerimasu
kakatte|kakarimasu
kaite|kakimasu
kashite|kashimasu
kiite|kikimasu
kitte|kirimasu
keshite|keshimasu
sutte|suimasu
dashite|dashimasu
tetsudatte|tetsudaimasu
totte|torimasu
naratte|naraimasu
nonde|nomimasu
haitte|hairimasu
hataraite|hatarakimasu
futte|furimasu
hanashite|hanashimasu
magatte|magariamsu
matte|machimasu
motte|mochimasu
moratte|moraimasu
yasunde|yasumimasu
yonde|yobimasu
yonde|yomimasu
wakatte|wakarimasu
