imasu|exist, be (referring to animate things)
arimasu|exist, be (referring to inanimate things)
iroiro|various
otoko no hito|man
onna no hito|woman
otoko no ko|boy
onna no ko|girl
inu|dog
neko|cat
ki|tree, wood
mono|thing
firumu|film
denchi|battery
hako|box
suicchi|switch
reizouko|refrigerator
teeburu|table
beddo|bed
tana|shelf
doa|door
mado|window
posuto|post
biru|building
kouen|park
kissaten|coffee shop
honya|bookstore
ya|~store
noriba|a fixed place to catch taxis, trains, etc.
ken|prefecture
ue|on, above, over
shita|under, below, beneath
mae|front, before
ushiro|back, behind
migi|right [side]
hidari|left [side]
naka|in, inside
soto|outside
tonari|next, next door
chikaku|near, vicinity
aida|between, among
nado|and so on
ichiban|the most~
danme|the -th shelf
doumo sumimasen|thank you (and sorry)
chirisoosu|chili sauce
oku|the back
supaisukoonaa|spice corner