norimasu|ride, get on (a train)
orimasu|get off (a train)
norikaemasu|change (trains, etc.)
abimasu|take (a shower)
iremasu|put in, insert
dashimasu|take out, withdraw
hairimasu|enter (university)
demasu|graduate from (university)
yamemasu|quit, retire, stop, give up
oshimasu|push, press
wakai|young
nagai|long
mijikai|short
akarui|bright, light
kurai|dark
se ga takai|tall (referring to person)
atama ga ii|clever, smart
karada|body
atama|head
kami|hair
kao|face
me|eye
mimi|ear
kuchi|mouth
ha|tooth
onaka|stomach
ashi|leg, foot
saabisu|service
joggingu|jogging
shawaa|shower
midori|green, greenery
otera|Buddhist temple
jinja|Shinto shrine
ryuugakusei|foreign student
ban|number-
douyatte|in what way, how
dono|which~ (used for three or more)
madamada desu|I still have a long way to go
ohikidashi desu ka|are you making a withdrawal?
mazu|first of all
kasshukaado|cash dispensing card
anshoubangou|PIN
tsugi ni|next, as a next step
kingaku|amount of money
kakunin|confirmation
botan|button