mul|water
gabang|bag
samusil|office
hakgyo|school
chaek|book
geo|thing
kamera|camera
keopi|coffee
sajeon|dictionary
haendeupon|cellphone
saram|person
uyu|milk
haksaeng|student
sul|liquor
goyangi|cat
sagwa|apple
orenji|orange
nalssi|weather
chingu|friend
sigan|time
jaemi|fun
maekju|beer
ton|money
mat|taste
tellebijeon|TV
nyuseu|news
hanguk|Korea
jib|home
seonmul|present
saengil|birthday
chukha|congratulation, celebration